| - - - - - - - - - - |
|                |    |
|                |    |
|                 ----|                             | - - - - - - - - - |
|                     |                             |                   |
| - - - - - n - - - - |                             |                   |
|                     |                             |                   |
|                     |                             |                   |
|                     |- - - - - - - - - - - - - - -|                   |
|          :)                                       |                   |
|                                                   D                   |
|                                                   |                   |
| - - - - - - - - - - - - - - - - - - - - - - - - - |                   |
                                                    |                   |
                                                    |                   |
                                                    |                   |
                                                    |                   |
                                                    | - - - - - - - - - |