                | - - - - - - - - - - |
                |                |    |
                |                |    |
                |          :)     ----|                             | - - - - - - - - - |
                |                     |                             |                   |
                | - - - - - n - - - - |                             |                   |
                |                     |                             |                   |
                |                     |                             |                   |
                |                     |- - - - - - - - - - - - - - -|                   |
                |                                                   |                   |
                |                                                   D                   |
                |                                                   |                   |
                | - - - - - - - - - - - - - - - - - - - - - - - - - |                   |
                                                                    |                   |
                                        | - - - - - - - - - - - - - |                   |
                                        |                           C                   |
                                        |       | - - - - - - - - - |                   |
                                        |       |                   | - - - - - - - - - |
| - - - - - - - | - - - - - - - - - - - |       | - - - - - - - - - | - - - - - - - - - |
|               |                                                   |                   |
|               |                                                   |                   |
|               |                                                   |                   |
|               C                                                   D                   |
|               |                                                   |                   |
|               |                                                   |                   |
|               |                                                   |                   |
|               |                                                   |                   |
| - - - - - - - | - - - - - - - - - - - u - - - - - - - - - - - - - | - - - - - - - - - |
                                |               |
                                |               |
                                |               |
                                |               |
                                |               |
                                |               |
                                |               |
                                |               |
                                |               |
                                |               |
                                |               |
                            | - - - - - u - - - - - |
                            |                       |
                            |                       |
                            |                       |
                            |                       |
                            |                       |
                            |                       |
                            | - - - - - - - - - - - |                            