| - - - - - - - - - - |
|                |    |
|          :)    |    |
|                 ----|
|                     |
| - - - - - n - - - - |